16 14
~~~~~~~@@@~~~~~~
~~~~~~~~~~~~~~~~
~~TT~~~~B~~~~TT~
~~~~~~~~~~~~~~~~
~~~~~~~~~~~~~~~~
~TTTT~~~-~~~TTTT
~TTT~~~@@@~~~TTT
~~~~~~~~~~~~~~~~
~~~~~~~~~~~~~~~~
~~$~~@-mmm-@~~s~
~~~~~~T~~~T~~~~~
~~~~~TTTTTTT~~~~
~TT~~TTT~TTT~~TT
~~~~~~~~~~~~~~~~