16 14
~~~~~~~~~~~~~~~~
~~~~~~~~~~~~~~~~
~~TT~~~~~~~~~TT~
~~~~~~~~~~~~~~~~
~~~~~~~~~~~~~~~~
~TTTT~~~~~~~TTTT
~TTT~~~~~~~~~TTT
~~~~~~~~~~~~~~~~
~~~~~~~~~~~~~~~~
~~~~~~~~~~~~~~~~
~~~~~~T~~~T~~~~~
~~~~~TTTTTTT~~~~
~TT~~TTT~TTT~~TT
~~~~~~~~~~~~~~~~