8 14
~TT~~~~T
~~~~~~~~
~~tt~~~~
~~~~~~~~
~~~~~~~~
~~~~~~~~
~~~~~~~~
~~~~~~~~
~~~~~~~~
~~~~~~~~
~~~~~~~~
~~~~~tt~
~~~~~~~~
~TT~~~~~