19 18
EEEEEEEEEEEEEEEEEEE
E~~~~~~~~~~~~~~~~~E
E~~~~~~~@@@~~~~~~~E
E~~~~~~~~~~~~~~~~~E
E~~TT~~~~B~~~~TT~~E
E~~~~~~~~~~~~~~~~~E
E~~~~~~~~~~~~~~~~~E
E~TTTT~~~-~~~TTTT~E
E~TTT~~~@@@~~~TTT~E
E~~~~~~~~~~~~~~~~~E
E~~~~~~~~~~~~~~~~~E
E~~$~~@-mmm-@~~s~~E
E~~~~~~T~~~T~~~~~~E
E~~~~~TTTTTTT~~~~~E
E~TT~~TTT~TTT~~TT~E
E~~~~~~~~~~~~~~~~~E
EEEEEEEEEEEEEEEEEEE
~~~~~~~~~~~~~~~~~~~