00000000000000000
00000K00000K00000
00000000000000000
00000M00000M00000
00V00000000000V00
00000KSGGGGK00000
00000TTTTTTT00S00
00000000000000000
00000000L00000000
0000L00000000L000
00000000000000000
00000000h00000000
00000000000000000