00000000000000000
00000K00000K00000
00000000000000000
00000000000K00000
00L00000000000L00
00000KSGGGGK00000
000G0TTTTTTTS0000
00000000000000000
00000000L00000000
0000L00000000L000
00000000000000000
00000000000000000
00000000000000000