00000000000000000
00000K00000K00000
00000000000000000
00000000000000000
00V00000000000V00
00000KSGGGGK00000
00000TTTTTTT00S00
00000000000000000
000L0000G00000L00
0000L00000000L000
000000000L0000000
00000000000000000
00000000000000000