00000000000000000
00000K00000K00000
00000000000000000
00000M00000M00000
00V00000000000V00
00000KGG0GGK00000
00000TRTRRTT00000
00000000L00000000
00000000000000000
0000L0h0h0h00L000
00000000000000000
00000000000000000
00000000000000000