:................
:................
:----------------
:================
1################
E...............|
E...............|
E...............|
-----...........|
=====...........|
####5...........|
ZZZZ:----000----|
ZZZZ:====0X0====|
ZZZZ:###########3
