ZZZZZZZZZZZZZZZZZ
ZZZZZZZZZZZZZZZZZ
ZZZZZZZZZZZZZZZZZ
#################
#################
................|
................|
................|
================|
################3
ZZZZZZZZZZZZZZZZZ
ZZZZZZZZZZZZZZZZZ
ZZZZZZZZZZZZZZZZZ
ZZZZZZZZZZZZZZZZZ