#################
:...............|
:...............|
:...............|
:...............|
:...............|
:...............|
:...............|
:...............|
:...............|
:---------------|
:===============|
1###############3