#################
:...............|
:...............|
:...............|
:...............Q##
:.................8
:.................8
:...............W##
:...............|
:...............|
:------000------|
:======0F0======|
1###############3