########9########
:...............|
:...............|
:...............|
:...............|
:...............|
:...............|
:...............|
:...............|
:...............|
:...............|
:...............|
1###############3