#######99########
:...............|
:...............|
:...............|
:...............|
:...............|
:...............|
:...............|
:...............|
:...............|
:...............|
:...............|
1###############3