####7666666*#####
76664......Q6666*
:...............|
:...............|
:...............|
:...............|
:...............|
:...............|
:...............|
:----.......----|
:====-------====|
1###5=======W###3
ZZZZ1#######3ZZZZ