:................
:................
:----------------
:================
1################
8...............|
8...............|
8...............|
-------..-------|
=======..=======|
######5..W######3
ZZZZZZ:..|ZZZZZZZ
ZZZZZZ:..|ZZZZZZZ
ZZZZZZ:EE|ZZZZZZZ
000000:EE|ZZZZZZZ

