ZZZZZZZ:..BBBB..|
ZZZZZZZ:........|
ZZZZZZZ:........|
ZZZZZZZ:........|
66666664........|
D...............|
D...............|
D...............|
--------........|
========........|
#######5........|
ZZZZZZZ:........|
ZZZZZZZ:........|
ZZZZZZZ:...X....|
ZZZZZZZ:........|

