#################
:...............|
:...............|
:...............|
:...............|
:...............|
:...............|
:...............|
:...............|
:...............|
:...............|
:...............|
1###############3