:................
:................
:----------------
:================
1################
8...............|
8...............|
8...............|
--------..------|
========..======|
#######5..W#####3
ZZZZZZZ:..|ZZZZZZ
ZZZZZZZ:..|ZZZZZZ
ZZZZZZZ:EE|ZZZZZZ
0000000:EE|ZZZZZZ

