#######################################
#.....................................#
#.........###........###........#.....#
#....####.#..........#..........####..#
#....#....#..........#................#
#....#..#.###........#................#
#....#..#............##################
#....#..#.............................#
#....#..#.............................#
#.......####.....######################
#.....................................#
#..............##########.............#
#.....................................#
#######################################