...................................................
...................................................
...................................................
...1___________________________________________2...
...|###########################################}...
...|...........................................}...
...|...........................................}...
...|...........................................}...
...|...........................................}...
...|...........................................}...
...|...........................................}...
...|...........................................}...
...|...........................................}...
...|....C......................................}...
...|...........................................}...
...|...........................................}...
1__4...........................................3__2
|#Z#...........................................#X#}
|.................................................}
|.......C.........................................}
|___...........................................___}
L##J...........................................K##R
...|...........................................}...
...|...........................................}...
...|...........................................}...
...|....C......................................}...
...|...........................................}...
...|...........................................}...
...|...........................................}...
...|______2....................................}...
...L######}....................................}...
..........3_2................................._}...
..........##32...............................4#R...
............#32.............................4#.....
.............#}............................4#......
..............}...........................4#.......
..............}..........................4#........
..............3_________________________4#.........
..............###########################..........
...................................................