...................................................
...................................................
...................................................
...1___________________________________________2...
...|####G###############################G######}...
...|...........................................}...
...|...........................................}...
...|...........................................}...
...|...........................................}...
...|...........................................}...
...|.........1=======2.........................}...
...|.........|.......}.........................}...
...|.........|.......}.......1========2........}...
...|.........|.......}.......|........}........}...
...|.........|_______}.......|........}........}...
...|.........L#######R.......|........}........}...
1__4.........................|________}........3__2
|#Z#.........................L#####GG#R........#X#}
|.................................................}
|.................................................}
|===...........................................===}
L$$J...........................................K$$R
...|...........................................}...
...|......1==========2.........1==========2....}...
...|......|..........}.........|..........}....}...
...|......|..........}.........|..........}....}...
...|......|..........}.........|..........}....}...
...|......|__2.......}.........|........1_}....}...
...|......L##3_______}.........|________4#R....}...
...|======2..###UUU##R.........L###VVV###......}...
...L$$$$$$}....................................}...
..........7=2.................................6}...
..........$$72...............................5$R...
............$72.............................5$.....
.............$}............................5$......
..............}...........................5$.......
..............}..........................5$........
..............3=========================5$.........
..............$$$$$$$$$$$$$$$$$$$$$$$$$$$..........
...................................................