...................................................
...................................................
...................................................
...1___________________________________________2...
...|####G###############################G######}...
...|...........................................}...
...|...........................................}...
...|...........................................}...
...|...........................................}...
...|...........................................}...
...|...........................................}...
...|...........................................}...
...|........................________2..........}...
...|....................|...}.......}..........}...
...|....................|...}.......}..........}...
...|....................|...}.......}..........}...
1__4............._______4...3_______}..........3__2
|#Z#.............########...#####GG#R..........#X#}
|.................................................}
|.................................................}
|___...........................................___}
L##J...........................................K##R
...|...........................................}...
...|.......__________2..........__________2....}...
...|.......}.........}..........}.........}....}...
...|.......}.........}..........}.........}....}...
...|.......}.........}..........}.........}....}...
...|.......3_2.......}..........}.......1_}....}...
...|.......##3_______}..........3_______4#R....}...
...|______2..###UUU##R..........###VVV###......}...
...L######}....................................}...
..........3_2.................................6}...
..........##32...............................5#R...
............#32.............................5#.....
.............#}............................5#......
..............}...........................5#.......
..............}..........................5#........
..............3_________________________5#.........
..............###########################..........
...................................................