...................................................
...................................................
...................................................
...1___________________________________________2...
...|####G###############################G######}...
...|...........................................}...
...|...........................................}...
...|...........................................}...
...|...........................................}...
...|...........................................}...
...|.........1=======2.........................}...
...|.........|.......}.........................}...
...|.........|.......}.......1========2........}...
...|.........|.......}.......|........}........}...
...|.........|_______}.......|........}........}...
...|.........L#######R.......|........}........}...
1__4.........................|________}........3__2
|#Z#.........................L#####GG#R........#X#}
|.................................................}
|.................................................}
|===...........................................===}
L$$J...........................................K$$R
...|...........................................}...
...|.......==========2..........==========2....}...
...|.......}.........}..........}.........}....}...
...|.......}.........}..........}.........}....}...
...|.......}.........}..........}.........}....}...
...|.......3_2.......}..........}.......1_}....}...
...|.......##3_______}..........3_______4#R....}...
...|======2..###UUU##R..........###VVV###......}...
...L$$$$$$}....................................}...
..........3=2.................................6}...
..........$$32...............................5$R...
............$32.............................5$.....
.............$}............................5$......
..............}...........................5$.......
..............}..........................5$........
..............3=========================5$.........
..............$$$$$$$$$$$$$$$$$$$$$$$$$$$..........
...................................................