...................................................
...................................................
...................................................
...BBBBBBBBBBBBBBBBBBBBBBBBBBBBBBBBBBBBBBBBBBBBB...
...B...........................................B...
...B...........................................B...
...B...........................................B...
...B..............B..............B.............B...
...B...........................................B...
...B...........................................B...
...B...........................................B...
...B..........BBBBBBB..........................B...
...B....B.....BBBBBBB.....................B....B...
...B..........BBBBBBB.........BBBBBBBB.........B...
...B..........BBBBBBB.........BBBBBBBB.........B...
...B..........................BBBBBBBB.........B...
.BBB..........................BBBBBBBB.........BBB.
B.................................................B
B.......B.................................B.......B
B.........................B.......................B
B.................................................B
BBBB...........................................BBBB
...B...........................................B...
...B...........................................B...
...B....B..BBBBBBBBBB...........BBBBBBBBBB.....B...
...B.......BBBBBBBBBB...........BBBBBBBBBB.....B...
...B.......BBB.....BB...........BB.....BBB.....B...
...B.......BBBBB.BBBB...........BBBB.BBBBB.....B...
...B.........BBBBBBBB...........BBBBBBBBB.......B...
...B............BBB................BBB.........B...
...BBBBBBB.....................................B...
........BB....................................B....
.........BBB.................................B.....
...........BB...............................B......
............BB.............................B.......
.............B............................B........
.............B...........................B.........
.............B..........................B..........
.............BBBBBBBBBBBBBBBBBBBBBBBBBBB...........
...................................................