,,,,,,,,,,,,,,,,,,,,,,,,,,,,,,,,,,,,,,,,,,,,,,,,,,,
,,,,,,,,,,,,,,,,,,,,,,,,,,,,,,,,,,,,,,,,,,,,,,,,,,,
,,,,,,,,,,,,,,,,,,,,,,,,,,,,,,,,,,,,,,,,,,,,,,,,,,,
,,,,,,,,,,,,,,,,,,,,,,,,,,,,,,,,,,,,,,,,,,,,,,,,,,,
,,,,...........................................,,,,
,,,,...........................................,,,,
,,,,...........................................,,,,
,,,,...........................................,,,,
,,,,...........................................,,,,
,,,,...........................................,,,,
,,,,...........................................,,,,
,,,,...........................................,,,,
,,,,...........................................,,,,
,,,,...........................................,,,,
,,,,...........................................,,,,
,,,,...........................................,,,,
,,,,...........................................,,,,
,,,,...........................................,,,,
,.................................................,
,.................................................,
,.................................................,
,,,,...........................................,,,,
,,,,...........................................,,,,
,,,,...........................................,,,,
,,,,...........................................,,,,
,,,,...........................................,,,,
,,,,...........................................,,,,
,,,,...........................................,,,,
,,,,...........................................,,,,
,,,,...........................................,,,,
,,,,,,,,,......................................,,,,
,,,,,,,,,,.....................................,,,,
,,,,,,,,,,,,..................................,,,,,
,,,,,,,,,,,,,................................,,,,,,
,,,,,,,,,,,,,,..............................,,,,,,,
,,,,,,,,,,,,,,.............................,,,,,,,,
,,,,,,,,,,,,,,............................,,,,,,,,,
,,,,,,,,,,,,,,...........................,,,,,,,,,,
,,,,,,,,,,,,,,,,,,,,,,,,,,,,,,,,,,,,,,,,,,,,,,,,,,,
,,,,,,,,,,,,,,,,,,,,,,,,,,,,,,,,,,,,,,,,,,,,,,,,,,,