,,,,,,,,,,,,,,,,,,,,,,,,,,,,,,,,,,,,,,,,,,,,,,,,,,,
,,,,,,,,,,,,,,,,,,,,,,,,,,,,,,,,,,,,,,,,,,,,,,,,,,,
,,,,,,,,,,,,,,,,,,,,,,,,,,,,,,,,,,,,,,,,,,,,,,,,,,,
,,,,,,,,,,,,,,,,,,,,,,,,,,,,,,,,,,,,,,,,,,,,,,,,,,,
,,,,.............CCCCCCCCCCCCCCCCCC............,,,,
,,,,..............CCCCCCCCCCCCCCCC.............,,,,
,,,,...............CCCCCCCCCCCCCC.....SS.......,,,,
,,,,.........SS...P.CCCCCCCCCCCC.P.............,,,,
,,,,.................CCCCCCCCCC................,,,,
,,,,..................CCCCCCCC.................,,,,
,,,,...................CCCCCC..................,,,,
,,,,..................P.CCCC.P.................,,,,
,,,,.....................CC.........S..........,,,,
,,,,....P..........................S......P....,,,,
,,,,.....................PP........S...........,,,,
,,,,...........................................,,,,
,,,,...........................................,,,,
,,,,...........................................,,,,
,.................................................,
,.......P.................................P.......,
,........................P........................,
,,,,...........................................,,,,
,,,,...........................................,,,,
,,,,...........................................,,,,
,,,,.......RRRRRRRRR............RRRRRRRRRR.....,,,,
,,,,....P..RRRRRRRRR............RRRRRRRRRR.....,,,,
,,,,.......RRRRRRRRR............RRRRRRRRRR.....,,,,
,,,,.......RRRRRRRRR............RRRRRRRRRR.....,,,,
,,,,.........RRRRRRRR...........RRRRRRRRRR.....,,,,
,,,,...........................................,,,,
,,,,,,,,,......................................,,,,
,,,,,,,,,,.....................................,,,,
,,,,,,,,,,,,..................................P,,,,
,,,,,,,,,,,,,................................P,,,,,
,,,,,,,,,,,,,,....SSS.............SSS.......P,,,,,,
,,,,,,,,,,,,,,....SSS.............SSS......P,,,,,,,
,,,,,,,,,,,,,,............................P,,,,,,,,
,,,,,,,,,,,,,,...........................P,,,,,,,,,
,,,,,,,,,,,,,,,,,,,,,,,,,,,,,,,,,,,,,,,,P,,,,,,,,,,
,,,,,,,,,,,,,,,,,,,,,,,,,,,,,,,,,,,,,,,,,,,,,,,,,,,