...................................................
...................................................
...................................................
...1___________________________________________2...
...|####G###############################G######}...
...|...........................................}...
...|...........................................}...
...|...........................................}...
...|...........................................}...
...|...........................................}...
...|...........................................}...
...|...........................................}...
...|...........................................}...
...|....................|...}..................}...
...|....................|...}..................}...
...|....................|...}..................}...
1__4............._______4...3_______...........3__2
|#Z#.............########...#####GG#...........#X#}
|.................................................}
|.................................................}
|___.............________...________...........___}
L##J.............###G###J...K#######...........K##R
...|....................|...}..................}...
...|.......__________...|...}...__________2....}...
...|.......}........J...L...R...}.........}....}...
...|.......}........J...........}.........}....}...
...|.......}........J...........}.........}....}...
...|.......3_2......J...........}.......1_}....}...
...|.......##3______4...........3_______4#R....}...
...|______2..###UUU##...........###VVV###......}...
...L######}....................................}...
..........3_2................................._}...
..........##32...............................4#R...
............#32.............................4#.....
.............#}............................4#......
..............}...........................4#.......
..............}..........................4#........
..............3_________________________4#.........
..............###########################..........
...................................................