,,,,,,,,,,,,,,,,,,,,,,,,,,,,,,,,,,,,,,,,,,,,,,,,,,,
,,,,,,,,,,,,,,,,,,,,,,,,,,,,,,,,,,,,,,,,,,,,,,,,,,,
,,,,,,,,,,,,,,,,,,,,,,,,,,,,,,,,,,,,,,,,,,,,,,,,,,,
,,,,,,,,,,,,,,,,,,,,,,,,,,,,,,,,,,,,,,,,,,,,,,,,,,,
,,,,.............CCCCCCCCCCCCCCCCCC............,,,,
,,,,.............CCCCCCCCCCCCCCCCCC............,,,,
,,,,.............CCCCCCCCCCCCCCCCCC...SS.......,,,,
,,,,.........SS.......................SS.......,,,,
,,,,.........SS...P..............P....SS.......,,,,
,,,,...........................................,,,,
,,,,...........................................,,,,
,,,,..........FFFFFFF..........................,,,,
,,,,..........RRRRRRR..........................,,,,
,,,,....P.....RRRRRRR.........FFFFFFFF....P....,,,,
,,,,..........RRRRRRR.........RRRRRRRR.........,,,,
,,,,..........................RRRRRRRR.........,,,,
,,,,..........................RRRRRRRR.........,,,,
,,,,..........SSSSSS...........................,,,,
,.................................................,
,.......P.......................SSSS......P.......,
,.........................P.....SSSS..............,
,,,,...........................................,,,,
,,,,..........SSSSSSS..........................,,,,
,,,,...........................................,,,,
,,,,.......FFFFFFFFFF...........FFFFFFFFFF.....,,,,
,,,,....P..RRRRRRRRRR...........RRRRRRRRRR.....,,,,
,,,,.......RRRRRRRRRR...........RRRRRRRRRR.....,,,,
,,,,.......RRRRRRRRRR...........RRRRRRRRRR.....,,,,
,,,,.........RRRRRRRR...........RRRRRRRRR......,,,,
,,,,...........................................,,,,
,,,,,,,,,......................................,,,,
,,,,,,,,,,.....................................,,,,
,,,,,,,,,,,,..................................P,,,,
,,,,,,,,,,,,,................................P,,,,,
,,,,,,,,,,,,,,....SSS.............SSS.......P,,,,,,
,,,,,,,,,,,,,,....SSS.............SSS......P,,,,,,,
,,,,,,,,,,,,,,............................P,,,,,,,,
,,,,,,,,,,,,,,...........................P,,,,,,,,,
,,,,,,,,,,,,,,,,,,,,,,,,,,,,,,,,,,,,,,,,P,,,,,,,,,,
,,,,,,,,,,,,,,,,,,,,,,,,,,,,,,,,,,,,,,,,,,,,,,,,,,,