...................................................
...................................................
...................................................
...BBBBBBBBBBBBBBBBBBBBBBBBBBBBBBBBBBBBBBBBBBBBB...
...B...........................................B...
...B...........................................B...
...B...........................................B...
...B.............B...............B.............B...
...B...........................................B...
...B...........................................B...
...B...........................................B...
...B...........................................B...
...B....B.................................B....B...
...B....................B...BBBBBBBB...........B...
...B....................B...BBBBBBBB...........B...
...B....................B...BBBBBBBB...........B...
...B....................B...BBBBBBBB...........B...
BBBB.............BBBBBBBB...BBBBBBBB...........BBBB
B.......B.................................B.......B
B.........................B.......................B
B.................................................B
BBBB...........................................BBBB
...B...........................................B...
...B...........................................B...
...B....B..BBBBBBBBBB...........BBBBBBBBBB.....B...
...B.......BBBBBBBBBB...........BBBBBBBBBB.....B...
...B.......BBBBBBBBBB...........BBBBBBBBBB.....B...
...B.......BBBBBBBBBB...........BBBBBBBBBB.....B...
...B.........BBBBBBBB...........BBBBBBBBB......B...
...B............BBB................BBB.........B...
...BBBBBB.....................................BB...
........BB...................................B.....
.........BBB................................B......
...........BB..............................B.......
............BB............................B........
.............B...........................B.........
.............B..........................B..........
.............B.........................B...........
.............BBBBBBBBBBBBBBBBBBBBBBBBBBB...........
...................................................