,,,,,,,,,,,,,,,,,,,,,,,,,,,,,,,,,,,,,,,,,,,,,,,,,,,
,,,,,,,,,,,,,,,,,,,,,,,,,,,,,,,,,,,,,,,,,,,,,,,,,,,
,,,,,,,,,,,,,,,,,,,,,,,,,,,,,,,,,,,,,,,,,,,,,,,,,,,
,,,,,,,,,,,,,,,,,,,,,,,,,,,,,,,,,,,,,,,,,,,,,,,,,,,
,,,,.............CCCCCCCCCCCCCCCCCC............,,,,
,,,,.............CCCCCCCCCCCCCCCCCC............,,,,
,,,,.............CCCCCCCCCCCCCCCCCC...SS.......,,,,
,,,,.........SS................................,,,,
,,,,..............P..............P.............,,,,
,,,,...........................................,,,,
,,,,...........................................,,,,
,,,,...........................................,,,,
,,,,................................S..........,,,,
,,,,....P..........................S......P....,,,,
,,,,...............................S...........,,,,
,,,,...........................................,,,,
,,,,...........................................,,,,
,,,,...........................................,,,,
,.................................................,
,.......P.................................P.......,
,.........................P.......................,
,,,,...........................................,,,,
,,,,...........................................,,,,
,,,,...........................................,,,,
,,,,.......RRRRRRRRR............RRRRRRRRRR.....,,,,
,,,,....P..RRRRRRRRR............RRRRRRRRRR.....,,,,
,,,,.......RRRRRRRRR............RRRRRRRRRR.....,,,,
,,,,.......RRRRRRRRR............RRRRRRRRRR.....,,,,
,,,,.........RRRRRRRR...........RRRRRRRRR......,,,,
,,,,...........................................,,,,
,,,,,,,,,......................................,,,,
,,,,,,,,,,.....................................,,,,
,,,,,,,,,,,,..................................P,,,,
,,,,,,,,,,,,,................................P,,,,,
,,,,,,,,,,,,,,....SSS.............SSS.......P,,,,,,
,,,,,,,,,,,,,,....SSS.............SSS......P,,,,,,,
,,,,,,,,,,,,,,............................P,,,,,,,,
,,,,,,,,,,,,,,...........................P,,,,,,,,,
,,,,,,,,,,,,,,,,,,,,,,,,,,,,,,,,,,,,,,,,P,,,,,,,,,,
,,,,,,,,,,,,,,,,,,,,,,,,,,,,,,,,,,,,,,,,,,,,,,,,,,,