,,,,,,,,,,,,,,,,,,,,,,,,,,,,,,,,,,,,,,,,,,,,,,,,,,,
,,,,,,,,,,,,,,,,,,,,,,,,,,,,,,,,,,,,,,,,,,,,,,,,,,,
,,,,,,,,,,,,,,,,,,,,,,,,,,,,,,,,,,,,,,,,,,,,,,,,,,,
,,,,,,,,,,,,,,,,,,,,,,,,,,,,,,,,,,,,,,,,,,,,,,,,,,,
,,,,.............CCCCCCCCCCCCCCCCCC............,,,,
,,,,.............CCCCCCCCCCCCCCCCCC............,,,,
,,,,.............CCCCCCCCCCCCCCCCCC...SS.......,,,,
,,,,.........SS................................,,,,
,,,,..............P..............P.............,,,,
,,,,...........................................,,,,
,,,,...........................................,,,,
,,,,...........................................,,,,
,,,,...................................S.......,,,,
,,,,....P...................RRRRRRRR..S...P....,,,,
,,,,........................RRRRRRRR..S........,,,,
,,,,........................RRRRRRRR...........,,,,
,,,,........................RRRRRRRR...........,,,,
,,,,...........................................,,,,
,.................................................,
,.......P.................................P.......,
,.........................P.......................,
,,,,...........................................,,,,
,,,,...........................................,,,,
,,,,...........................................,,,,
,,,,.......RRRRRRRRRR...........RRRRRRRRRR.....,,,,
,,,,....P..RRRRRRRRRR...........RRRRRRRRRR.....,,,,
,,,,.......RRRRRRRRRR...........RRRRRRRRRR.....,,,,
,,,,.......RRRRRRRRRR...........RRRRRRRRRR.....,,,,
,,,,.........RRRRRRRR...........RRRRRRRRR......,,,,
,,,,...........................................,,,,
,,,,,,,,,......................................,,,,
,,,,,,,,,,.....................................,,,,
,,,,,,,,,,,,..................................P,,,,
,,,,,,,,,,,,,................................P,,,,,
,,,,,,,,,,,,,,....SSS.............SSS.......P,,,,,,
,,,,,,,,,,,,,,....SSS.............SSS......P,,,,,,,
,,,,,,,,,,,,,,............................P,,,,,,,,
,,,,,,,,,,,,,,...........................P,,,,,,,,,
,,,,,,,,,,,,,,,,,,,,,,,,,,,,,,,,,,,,,,,,P,,,,,,,,,,
,,,,,,,,,,,,,,,,,,,,,,,,,,,,,,,,,,,,,,,,,,,,,,,,,,,