________
........
........
........
........
........
........
--------