T________Y
/........\
/........\
/........\
/........\
/........\
L........J
 --------