1====.====2
|.........|
|.........|
|..S......|
|.........|
...........
|.........|
|..S......|
|.........|
|....H....|
3=========4
                 