1====.====2
|.........|
|.........|
|...S.S...|
|.........|
...........
|.........|
|...S.S...|
|.........|
|.........|
3====.====4
                 