1====.====2
|.........|
|.........|
|..S......|
|.........|
.....B.....
|.........|
|..S......|
|.........|
|.........|
3=========4
                 
                 