1====.====2
|.........|
|.........|
|...S.....|
|.........|
......S....
|.........|
|...S.....|
|.........|
|.........|
3====.====4
                 
                 
                 