1====.====2
|........p|
|.........|
|.........|
|.........|
...........
|.........|
|.........|
|......t..|
|p......tt|
3====.====4     
                 