1====.====2
|.......pp|
|.........|
|.........|
|.........|
...........
|.........|
|tt.......|
|.t.......|
|.........|
3====.====4 
                 